NO ./textures/north.xpm
SO ./textures/south.xpm
WE ./textures/west.xpm
EA ./textures/east.xpm

F  220,100,0
C  225,30,0

1111
1001
1101
10N1
1111