NO ./textures/north.xpm
SO ./textures/south.xpm
WE ./textures/west.xpm
EA ./textures/east.xpm

F 30,30,30
C 60,60,60

1111
1001
1101
10N1
1111