NO ./n.xpm
SO ./s.xpm
WE ./w.xpm
EA ./e.xpm
F 220,100,0
C 225,30,0

11111
1N001
10001
11111
