NO ./n.xpm
SO ./s.xpm
WE ./w.xpm
EA ./e.xpm
F 12,34,56
C 78,90,12

  11111
  1N001
  10001
  11111
