NO ./n.xpm
SO ./s.xpm
WE ./w.xpm
EA ./e.xpm
F 000,007,42
C 5,6,7


















11111
1N001
10001
11111


