NO ./a.xpm
SO ./b.xpm
WE ./c.xpm
EA ./d.xpm
F 0,128,255
C 255,0,128

111111
1N0001
111 11
111111
