NO ./n.xpm
SO ./s.xpm
WE ./w.xpm
EA ./e.xpm
F 10,20,30
C 200,210,220

11111
1	001
10001
11111
