NO ./t/no.xpm
SO ./t/so.xpm
WE ./t/we.xpm
EA ./t/ea.xpm

F  100,100,100
C  50,50,50

1111111
1N00001
1001001
1000000
1111111