NO ./n1.xpm
NO ./n2.xpm
SO ./s.xpm
WE ./w.xpm
EA ./e.xpm
F 1,2,3
C 4,5,6


1111
1N01
1001
1111
