NO ./t/no.xpm
SO ./t/so.xpm
WE ./t/we.xpm
EA ./t/ea.xpm

F  0,0,0
C  255,255,255

11111111
1000  01
10  N 01
1000  01
11111111